1111111111111111111111111111111
100S111111111111100010001111111
100B111110001111000111000111111
1000111100000110001111100011111
1000100100000000000000000001111
1100000100011110000001110000111
111111010001F000000011111000011
1000000000010000000001110000001
1000000000011111000000000000001
1111110000011111111111111111111
1111111000111111111111111111111
1111111111111111111111111111111
1111111111111111111111111111111