1111111111
1S00000001
100000B001
1000100001
10B000F001
1000111111
100F011111
1000001111
1000000111
1111111111